%%%%%%%%%%%%%%%%%%%%%%%%%%%%%%%%%%%%%
%                                  .%
%                                   %
%                                   %
%                                   %
%                                   %
%                                   %
%                                   %
%                                   %
%                                   %
%                                   %
%                                   %
%                                   %
%                                   %
%                                   %
%                                   %
%                                   %
%                                   %
%                                   %
%                                   %
%                                   %
%                                   %
%                                   %
%                                   %
%                                   %
%                                   %
%                                   %
%                                   %
%                                   %
%                                   %
%                                   %
%                                   %
%                                   %
%                                   %
%                                   %
% % % %       %   %P      %   % %   %
%%%%%%%%%%%%%%%%%%%%%%%%%%%%%%%%%%%%%
