%%%%%%%%%%%%%%%%%%%%%%%%%%%%%%%%%%%%%
%       % % %           %   %     % %
%                                   %
%       %       % %     %     % %   %
%%%%% %%%%% %%% % % % %%% %%%%% % %%%
%   % % % %   % % % %   % %   % %   %
%                                   %
%       %     %   %   %     % % %   %
%                                   %
%             %       % %   %     % %
% % %%%%% % %%% % % %%% % %%% %%% % %
% % %     % % % % %     %   % % % % %
%                                   %
% % % %     %   %     %     %   %   %
%%%                               % %
%     % % %     % %     % %   % % % %
% % % % % %%% %%% %%% %%% % % % % % %
% % % % %                 % % %     %
%                                  %%
%       % % % %     %   %     % %   %
%                                   %
%   % %           % %     %   % %   %
%                                   %
% %   %      %        %     %       %
% % % %%%%% %%% % % % % %%%%%%%%%%%%%
% % %   %     % % % %       %   % % %
%                                   %
% %   % %   % % %   % %   % % %     %
% %                                %%
%       %   %     % %     %   % %   %
%                                  %%
% % % % % % % %     %P%   % %   % % %
% % %%% % % % % %%%%%%%%% % % % % % %
%   %   %   %                 %     %
%                                   %
%.% % %       %   %       %   % %   %
%%%%%%%%%%%%%%%%%%%%%%%%%%%%%%%%%%%%%
