%%%%%%%%%%%%%%%%%%%%%%%%%%%%%%%%%%%%
%                                  %
%                                  %
%                                  %
%                  P               %
%                                  %
%                                  %
%                                  %
%                                  %
%                                  %
%                                  %
%                                  %
%                                  %
%                                  %
%                                  %
%                                  %
%.         %%%%%%%%%%%%%%%%        %
%%%%%%%%%%%%%%%%%%%%%%%%%%%%%%%%%%%%
